base64 - base64 encode/decode data and print to standard output - reduce - pure
basename - strip directory and suffix from filenames - transform - pure
cat - concatenate files and print on the standard output - generate - side_effect - source
cat - concatenate files and print on the standard output - transform - pure - step
chcon - change file security context
chgrp - change group ownership
chmod - change file mode bits
chown - change file owner and group
cksum - checksum and count the bytes in a file - reduce - pure
comm - compare two sorted files line by line - generate - side_effect - source
cp - copy files and directories
csplit - split a file into sections determined by context lines
cut - remove sections from each line of files - transform - pure - step
date - print or set the system date and time - generate - side_effect - source
dd - convert and copy a file - 
df - report file system disk space usage - generate - side_effect - source
dircolors - color setup for ls
dirname - strip last component from file name - map - pure - step
du - estimate file space usage - generate - side_effect - source
echo - display a line of text - generate - 
env - run a program in a modified environment
expand - convert tabs to spaces - transform - pure - step
expr - evaluate expressions
factor - factor numbers
false - do nothing, unsuccessfully - constant - pure - sink
fmt - simple optimal text formatter - transform - pure - step
fold - wrap each input line to fit in specified width
groups - print the groups a user is in - map - side_effect - step
HEAD - Simple command line user agent
head - output the first part of files - filter - pure - step
hostid - print the numeric identifier for the current host - generate - side_effect - source
hostname - show or set the system's host name - generate
id - print real and effective user and group IDs - generate
install - copy files and set attributes - 
join - join lines of two files on a common field
kill - send a signal to a process
link - call the link function to create a link to a file
ln - make links between files
logname - print user's login name - generate
ls - list directory contents - generate
md5sum - compute and check MD5 message digest - reduce
mkdir - make directories - map
mkfifo - make FIFOs (named pipes) - map
mknod - make block or character special files - map
mktemp - create a temporary file or directory - map
mv - move (rename) files - map
nice - run a program with modified scheduling priority
nl - number lines of files
nohup - run a command immune to hangups, with output to a non-tty
nproc - print the number of processing units available - generate
numfmt - Convert numbers from/to human-readable strings - format
od - dump files in octal and other formats - generate
paste - merge lines of files
pathchk - check whether file names are valid or portable
pinky - lightweight finger
pr - convert text files for printing - format
printenv - print all or part of environment - generate
printf - format and print data - format
ptx - produce a permuted index of file contents
pwd - print name of current/working directory - generate
readlink - print resolved symbolic links or canonical file names
realpath - print the resolved path
rm - remove files or directories - map
rmdir - remove empty directories - map
runcon - run command with specified security context
seq - print a sequence of numbers - generate
shred - overwrite a file to hide its contents, and optionally delete it - map
shuf - generate random permutations - generate
sleep - delay for a specified amount of time
sort - sort lines of text files - sort
split - split a file into pieces
stat - display file or file system status
stdbuf - Run COMMAND, with modified buffering operations for its standard streams.
stty - change and print terminal line settings
sum - checksum and count the blocks in a file - reduce
sync - Synchronize cached writes to persistent storage
tac - concatenate and print files in reverse - generate
tail - output the last part of files - filter
tee - read from standard input and write to standard output and files
test - check file types and compare values
timeout - run a command with a time limit
touch - change file timestamps - map
tr - translate or delete characters - transform
true - do nothing, successfully
truncate - shrink or extend the size of a file to the specified size
tsort - perform topological sort - sort
tty - print the file name of the terminal connected to standard input
uname - print system information - generate
unexpand - convert spaces to tabs - transform
uniq - report or omit repeated lines - reduce
unlink - call the unlink function to remove the specified file
uptime - Tell how long the system has been running. - generate
users - print the user names of users currently logged in to the current host - generate
wc - print newline, word, and byte counts for each file - reduce
whoami - print effective userid - generate
who - show who is logged on - generate
yes - output a string repeatedly until killed
